011111111111111111111111111112
9NNNNNNNNNNNNNNNNNNNNNNNNNNNNb
9NNNNNNNNNNNNNNNNNNNNNNNNNNNNb
9NNNNNNNNNNNNNNNNNNNNNNNNNNNNb
9NNNNNNNNNNNNNNN5NNNNNNNNNNNNb
9NNNNNNNNNNNNrsssssssssssssstb
9NNNNNNNNNNNNAmmmmmmmmmmmmmmml
9NNNNNNNNNNNNAmuKKKKKKKKKKKKLb
9NNNNNNNNNNNNAmCNNNNN5NNNNNNNb
9NNNNNNNNNNNNAmCNNNNNNNNNNNNNb
9NNN5N5NNNN5NAmC5NNNNNNNNNNNNb
9ssssssssssssEmCNNNNNNNNNNNNNb
MmmmmmmmmmmmmmmCNNNNNNNNNNNNNb
9KKKKKKKKKKKKKKLNNNNNNNNNNNNNb
9NNNNNNNN5NNNNNNNNNNNNNNNNNNNb
9NNNNNNNNNNNNNNNNNNNNNNNNNNNNb
ijjjjjjjjjjjjjjjjjjjjjjjjjjjjk
